,-----------------------------.----------------------------------.    
|                             |                                  |    
|    .    .    ,---------     |     ------------------------.    |    
|    |    |    |              |                             |    |    
|    |    `----"--------------'    ,-------------------.    |    |    
|    |                             |                   |    |    |    
|    :--------------.--------------"----     ,---------:    |    |    
|    |              |                        |         |    |    |    
|    :---------     |    .    ,---------.    |    .    |    `----:    
|    |              |    |    |         |    |    |    |         |    
|    |     ---------'    |    :----     |    |    |    |    .    |    
|    |                   |    |         |    |    |    |    |    |    
|    `-------------------'    |     ----'    |    |    |    |    |    
|                             |              |    |    |    |    |    
:--------------.---------.    :--------------'    |    :----'    |    
|              |         |    |                   |    |         |    
|    .    .    |    .    |    |    ,--------------:    `----     |    
|    |    |    |    |    |    |    |              |              |    
|    |    |    "    |    |    |    |     ---------"---------.    |    
|    |    |         |    |    |    |                        |    |    
|    |    `---------"----'    |    |    ,---------.    .    |    |    
|    |                        |    |    |         |    |    |    |    
|    :---------.--------------:    |    |    .    |    |    |    |    
|    |         | X            |    |    |    |    |    |    |    |    
|    "    .    `---------     |    |    `----'    |    `----'    |    
|         |                   |    |              |              |    
`---------"-------------------'    `--------------"--------------'